ID,NAME_Z1,NAME_Z2,ALLIANCE_Z1,ALLIANCE_Z2,POSITION_Z1,POSITION_Z2,POSITION_CHANGE,POWER_Z1,POWER_Z2,POWER_CHANGE,KP_Z1,KP_Z2,KP_CHANGE,DEATHS_Z1,DEATHS_Z2,DEATHS_CHANGE,RSS_ASSIST_Z1,RSS_ASSIST_Z2,RSS_ASSIST_CHANGE,T4KILLS_Z1,T4KILLS_Z2,T4KILLS_CHANGE,T5KILLS_Z1,T5KILLS_Z2,T5KILLS_CHANGE
153836735,ᵀᴱAlfyx,ᵀᴱAlfyx,[1/TE]Twilight~Errant,[1/TE]Twilight~Errant,1,1,0,317267614,317267614,0,1623779,1623779019,1622155240,16317159,16317159,0,39447572236,39447572236,0,123802544,123802544,0,123802544,17812890,0
4852411,ᵀᴱ Bank,ᵀᴱ Bank,[1/TE]Twilight~Errant,[1/TE]Twilight~Errant,2,2,0,85575136,85586736,11600,3873790,3873790308,3869916518,17944411,17944411,0,8765149749,8765149749,0,227460446,227460446,0,227460446,77298006,0
16447927,ᵀᴱBaPяГ,ᵀᴱBaPяГ,#error#,#error#,3,3,0,78174341,78174341,0,419626,419626862,419207236,8570269,8570269,0,4669424676,4669424676,0,23231611,23231611,0,23231611,9022676,0
147494688,ᴼᴹ Tya,ᴼᴹ Tya,[OM/1]OGAH MUNDURR,[OM/1]OGAH MUNDURR,4,4,0,67373087,67707137,334050,118132,118132354,118014222,1520638,1520638,0,271890429,271890429,0,9605024,9605024,0,9605024,977072,0
1208539,么Mentalistic,么Mentalistic,[1/TE]Twilight~Errant,[1/TE]Twilight~Errant,5,5,0,64847478,63859724,-987754,2309146,2315339769,2313030623,23311404,23388477,77073,18559900845,18559900845,0,137706699,138078075,371376,137706699,41311007,123955
23617798,ᵀᴱ FaĆa,ᵀᴱ FaĆa,[1/TE]Twilight~Errant,[1/TE]Twilight~Errant,6,10,4,61606352,61384809,-221543,1600970,1602888872,1601287902,22092528,22170972,78444,6065513951,6065513951,0,99918244,100030290,112046,99918244,26260429,39895
10064802,IIMHMT2,IIMHMT2,[1/TE]Twilight~Errant,[1/TE]Twilight~Errant,7,8,1,61525664,62347668,822004,4908992,4912930314,4908021322,21697916,21847047,149131,23917326943,23917326943,0,253974288,254283566,309278,253974288,116462007,42162
21653214,ᵀᴱAńuBÎs㋳,ᵀᴱAńuBÎs㋳,[1/TE]Twilight~Errant,[1/TE]Twilight~Errant,8,7,-1,61254915,62385650,1130735,2157956,2160381656,2158223700,15650119,15688949,38830,18802810086,18867810086,65000000,115086778,115233122,146344,115086778,46886048,48076
5013459,Lady 공주ʚĩɞ,Lady 공주ʚĩɞ,[1/TE]Twilight~Errant,[1/TE]Twilight~Errant,9,6,-3,62762548,62587623,-174925,3609073,3613436741,3609827668,19671636,19714068,42432,19423756522,19423756522,0,224842583,225105340,262757,224842583,65144310,86784
128464126,ᵀᴱ NVT DPM,ᵀᴱ NVT DPM,[1/TE]Twilight~Errant,[1/TE]Twilight~Errant,10,9,-1,60908540,61859224,950684,596439,599145812,598549373,2657127,2673690,16563,632394117,632394117,0,36300730,36382204,81474,36300730,11232925,94562
110544014,ᵀᴱBZRP,ᵀᴱBZRP,[1/TE]Twilight~Errant,[1/TE]Twilight~Errant,11,11,0,60367959,60704882,336923,671419,671457883,670786464,4423952,4423952,0,1573598001,1573598001,0,38517086,38520889,3803,38517086,13895025,0
43752815,义Sir Alaa2义,义Sir Alaa2义,[1/TE]Twilight~Errant,[1/TE]Twilight~Errant,12,12,0,59924795,59802241,-122554,1623504,1624422768,1622799264,17866720,17912780,46060,7114271285,7114271285,0,67008317,67070468,62151,67008317,46173221,14796
68694285,ᵀᴱdeaveman,ᵀᴱdeaveman,[1/TE]Twilight~Errant,[1/TE]Twilight~Errant,13,13,0,59687757,59685614,-2143,371406,374434709,374063303,14786979,14849735,62756,374438289,374438289,0,23071493,23286548,215055,23071493,6043717,36659
76618024,Arthur XV,Arthur XV,[JH31]JANDA HUNTER XV,[OM/1]OGAH MUNDURR,14,14,0,59563549,59604349,40800,736400,736400601,735664201,6711116,6711116,0,55083810974,55083810974,0,50254670,50254670,0,50254670,9382539,0
41885448,K V H,K V H,[1/TE]Twilight~Errant,[31Ws]Whisky & Soda,15,16,1,58958915,58197935,-760980,585009,586514290,585929281,6777645,6824011,46366,3265368281,3265368281,0,33889830,34025181,135351,33889830,10378921,7484
153823208,Kremitdforg,Kremitdforg,[JH31]JANDA HUNTER XV,[JH31]JANDA HUNTER XV,16,15,-1,58651301,58616535,-34766,136477,136484372,136347895,1752303,1762126,9823,236990750,236990750,0,10783986,10784611,625,10783986,1276418,0
72978238,ᵀᴱ Hieu f2p,ᵀᴱ Hieu f2p,[1/TE]Twilight~Errant,[1/TE]Twilight~Errant,17,19,2,58507446,57619710,-887736,1882807,1887808849,1885926042,18478574,18590194,111620,5813878964,5813878964,0,98178444,98472547,294103,98178444,43667466,102996
65225685,ᵀᴱJehovany,ᵀᴱJehovany,[1/TE]Twilight~Errant,[1/TE]Twilight~Errant,18,17,-1,58099858,57813948,-285910,783848,784987196,784203348,9181841,9214512,32671,1707670563,1707670563,0,54438736,54519316,80580,54438736,11527583,16641
58058044,ᵀᴱ DukeMigz,ᵀᴱ DukeMigz,[1/TE]Twilight~Errant,[1/TE]Twilight~Errant,19,18,-1,57661599,57678803,17204,2231229,2231691252,2229460023,10986497,10986497,0,18165512158,18165512158,0,154436897,154483055,46158,154436897,29585092,0
52696557,ᵀᴱNoChance,ᵀᴱNoChance,[1/TE]Twilight~Errant,[OM/1]OGAH MUNDURR,20,20,0,57648395,57167765,-480630,1056872,1063244784,1062187912,10917530,10958862,41332,3235701005,3235701005,0,68025051,68608994,583943,68025051,16419405,26628
125634624,ᵀᴱKHATHUHAI,ᵀᴱKHATHUHAI,[1/TE]Twilight~Errant,[1/TE]Twilight~Errant,21,23,2,56423470,55838382,-585088,1256082,1268342572,1267086490,5921019,6082800,161781,1943824364,1943824364,0,90658894,91295813,636919,90658894,15239522,294513
106308292,ᵀᴱ smile,ᵀᴱ smile,[1/TE]Twilight~Errant,[1/TE]Twilight~Errant,22,21,-1,56297184,56352874,55690,220298,220298799,220078501,4540302,4540302,0,2147302228,2147302228,0,12535928,12535928,0,12535928,4568546,0
109032862,ᴼᵐShanksヅ,ᴼᵐShanksヅ,[OM/1]OGAH MUNDURR,[OM/1]OGAH MUNDURR,23,24,1,54877383,54880089,2706,651405,651405980,650754575,6281899,6281899,0,8074047679,8074047679,0,47724377,47724377,0,47724377,7934418,0
97192085,ᵀᴱ Papi 㐅,ᵀᴱ Papi 㐅,[1/TE]Twilight~Errant,[1/TE]Twilight~Errant,24,22,-2,55021206,56287122,1265916,667684,674494765,673827081,4723456,4847653,124197,5332704174,5332704174,0,50663803,51096743,432940,50663803,6448251,124053
59538032,Noᴍᴇʀᴄʏ,Noᴍᴇʀᴄʏ,[1/TE]Twilight~Errant,[1/TE]Twilight~Errant,25,26,1,54594220,54337950,-256270,297735,297777768,297480033,8407125,8407125,0,4215721363,4215721363,0,16392220,16396476,4256,16392220,6133590,0
147724962,ᶻᵉPopeye,ᶻᵉPopeye,[31Ws]Whisky & Soda,[31Ws]Whisky & Soda,26,27,1,53113206,53007566,-105640,288698,297608334,297319636,1563394,1711891,148497,319709367,319709367,0,22197694,22704276,506582,22197694,1894509,192197
71056110,ᴼᵐ A K D,ᴼᵐ A K D,[OM/1]OGAH MUNDURR,[OM/1]OGAH MUNDURR,27,25,-2,54572597,54572597,0,347333,347333455,346986122,14088783,14088783,0,14323225737,14323225737,0,22543372,22543372,0,22543372,4925325,0
146515802,SrPerxita,SrPerxita,[1/TE]Twilight~Errant,[1/TE]Twilight~Errant,28,29,1,52849598,51165068,-1684530,424501,425313001,424888500,2909182,2914217,5035,3657456772,3657456772,0,32205414,32229262,23848,32205414,2963993,28633
129315599,ᵀᴱ Mattos,ᵀᴱ Mattos,[1/TE]Twilight~Errant,[1/TE]Twilight~Errant,29,28,-1,52182098,51633047,-549051,980128,996101760,995121632,5460239,5518582,58343,4396643484,4396643484,0,68769028,70181570,1412542,68769028,12893627,91915
121314402,ᵀᴱ МİRKAN,ᵀᴱ МİRKAN,[1/TE]Twilight~Errant,[1/TE]Twilight~Errant,30,31,1,50663461,50674991,11530,135878,135878897,135743019,5078720,5078720,0,120228576,120228576,0,8424280,8424280,0,8424280,1388903,0
153748321,ᴼᵐFlovey,ᴼᵐFlovey,[JH31]JANDA HUNTER XV,[OM/1]OGAH MUNDURR,31,30,-1,50438526,50698379,259853,544121,560656032,560111911,1770674,1862929,92255,447555912,447555912,0,45210375,46593873,1383498,45210375,3933824,134964
126812282,ᵀᴱ Mr Báo,ᵀᴱ Mr Báo,[1/TE]Twilight~Errant,[1/TE]Twilight~Errant,32,32,0,48480564,48500033,19469,466280,466552429,466086149,5390980,5390980,0,2605503575,2605503575,0,33780612,33791008,10396,33780612,3984916,8410
123432042,ᵀᴱ Weedaa,ᵀᴱ Weedaa,[1/TE]Twilight~Errant,[1/TE]Twilight~Errant,33,33,0,47767056,47805785,38729,858986,858986726,858127740,6110136,6110136,0,4145915571,4145915571,0,60953955,60953956,1,60953955,8203719,0
134324785,Venom Groot,Venom Groot,[31Ws]Whisky & Soda,[1/TE]Twilight~Errant,34,34,0,45202767,44886703,-316064,63323083,63780053,456970,1496679,1543564,46885,779207377,779207377,0,4595233,4634362,39129,4595233,771642,3284
147705376,ᶻᵉRayard91,ᶻᵉRayard91,[31Ws]Whisky & Soda,[31Ws]Whisky & Soda,35,36,1,44842857,44231077,-611780,123439,126072261,125948822,925836,973640,47804,155277371,155277371,0,10547485,10750064,202579,10547485,545619,30328
147686316,ʷˢ Potato,ʷˢ Potato,[OM/1]OGAH MUNDURR,[31Ws]Whisky & Soda,36,39,3,44224834,43125585,-1099249,353805,375382348,375028543,1069565,1132290,62725,54736421,54736421,0,31840408,33835467,1995059,31840408,602577,14042
45520400,KragerAtTwitch,KragerAtTwitch,[OM/1]OGAH MUNDURR,[1/TE]Twilight~Errant,37,35,-2,44241580,44241980,400,205015,205015065,204810050,10880856,10880856,0,6564685322,6564685322,0,8284204,8284204,0,8284204,6015040,0
134727068,ᵀᴱ Rambo,ᵀᴱ Rambo,[1/TE]Twilight~Errant,[1/TE]Twilight~Errant,38,38,0,43126709,43520155,393446,540975,540975467,540434492,5505478,5505478,0,829345160,829345160,0,35646568,35646568,0,35646568,7084741,0
114263492,ᵀᴱ cafe24h,ᵀᴱ cafe24h,[1/TE]Twilight~Errant,[1/TE]Twilight~Errant,39,37,-2,43170753,43553053,382300,394330,394330203,393935873,7842700,7842700,0,1363452666,1363452666,0,22177430,22177430,0,22177430,8296927,0
93934189,Ritch mahal ko,Ritch mahal ko,[1/TE]Twilight~Errant,[31Ws]Whisky & Soda,40,40,0,43001795,43053695,51900,141991,141991705,141849714,4367488,4367488,0,498726635,498726635,0,9039698,9039698,0,9039698,2083749,0
136243598,ᵀᴱ Maple,ᵀᴱ Maple,[1/TE]Twilight~Errant,[1/TE]Twilight~Errant,41,41,0,42338142,42526670,188528,277303,279093652,278816349,3184617,3219910,35293,1582151422,1582151422,0,19345338,19454449,109111,19345338,3593258,34560
147612752,The Doctor90,The Doctor90,[31Ws]Whisky & Soda,[31Ws]Whisky & Soda,42,42,0,42611278,42441882,-169396,84695823,85128532,432709,826433,826433,0,110752401,110752401,0,7088150,7126235,38085,7088150,582447,2215
145383896,ᵏˢ Taduke,ᵏˢ Taduke,[1/TE]Twilight~Errant,[1/TE]Twilight~Errant,43,44,1,42432937,42142237,-290700,230033,232354161,232124128,1705250,1716869,11619,203010842,203010842,0,18249127,18419240,170113,18249127,1605884,30975
145222449,ʷˢ Lakouss,ʷˢ Lakouss,[31Ws]Whisky & Soda,[31Ws]Whisky & Soda,44,43,-1,42221099,42330119,109020,83619101,83619101,0,683210,683210,0,595879178,595879178,0,6032764,6032764,0,6032764,967053,0
119696394,Wujaaaa,Wujaaaa,[OM/1]OGAH MUNDURR,[31Ws]Whisky & Soda,45,45,0,40721626,39710197,-1011429,99520813,101203879,1683066,4802081,4869749,67668,704263417,704263417,0,6129442,6247494,118052,6129442,1787609,25058
119524703,Bourbon Queen,Bourbon Queen,[31Ws]Whisky & Soda,[31Ws]Whisky & Soda,46,47,1,39342880,38748844,-594036,249101,252540685,252291584,4816238,4894386,78148,1351293655,1366293655,15000000,16564963,16832353,267390,16564963,3338005,38289
145217939,ʷˢGuillaume,ʷˢGuillaume,[31Ws]Whisky & Soda,[31Ws]Whisky & Soda,47,50,3,38479558,37947290,-532268,89130335,91889505,2759170,1585075,1652567,67492,40620636,40620636,0,6624182,6811707,187525,6624182,712799,44196
146133392,ᵀᴱYiğit,ᵀᴱYiğit,[1/TE]Twilight~Errant,[1/TE]Twilight~Errant,48,48,0,39471748,38542754,-928994,187864,190783300,190595436,2648366,2648366,0,871256326,871256326,0,14073440,14243596,170156,14073440,1666605,60879
147955047,La Linea,La Linea,[31Ws]Whisky & Soda,[31Ws]Whisky & Soda,49,46,-3,38828380,38911928,83548,17887898,17887898,0,249402,249402,0,24248510,24248510,0,1527030,1527030,0,1527030,72732,0
153062655,乂irrelephant,乂irrelephant,[1/TE]Twilight~Errant,[1/TE]Twilight~Errant,50,49,-1,38189281,38217281,28000,85267332,85267332,0,696867,696867,0,224035773,224035773,0,6759312,6759312,0,6759312,581331,0
150768637,ʷˢViTAMiN,ʷˢViTAMiN,[31Ws]Whisky & Soda,[31Ws]Whisky & Soda,51,51,0,37998650,37668467,-330183,137869,141120176,140982307,617784,655927,38143,1486341503,1486341503,0,11053897,11219473,165576,11053897,1278190,79768
132914869,ᵀᴱ côbảy,ᵀᴱ côbảy,[OM/1]OGAH MUNDURR,[1/TE]Twilight~Errant,52,54,2,37399342,37405882,6540,192821,193124229,192931408,4632725,4632725,0,1258659360,1363659360,105000000,16218829,16233289,14460,16218829,1130668,7887
150936241,ᴹᴾGoransson,ᴹᴾGoransson,[31Ws]Whisky & Soda,[31Ws]Whisky & Soda,53,52,-1,37092027,37481223,389196,34423845,35656225,1232380,305248,413741,108493,443537560,443537560,0,2293178,2368452,75274,2293178,460380,23982
153170974,MongolXXX,MongolXXX,[OM/1]OGAH MUNDURR,[OM/1]OGAH MUNDURR,54,53,-1,37183040,37434770,251730,143956,143956044,143812088,683569,683569,0,36373240,36373240,0,11862520,11862520,0,11862520,944139,0
146727364,RAVAGe,RAVAGe,[1/TE]Twilight~Errant,[1/TE]Twilight~Errant,55,55,0,37029522,36986154,-43368,323400,325123483,324800083,1132196,1150643,18447,643577062,643577062,0,27095362,27227706,132344,27095362,1142459,19926
148357561,ᵀᴱklyde,ᵀᴱklyde,[1/TE]Twilight~Errant,[1/TE]Twilight~Errant,56,56,0,36081463,36166803,85340,218709,218709753,218491044,2014316,2014316,0,732462165,732462165,0,15816524,15816524,0,15816524,2587298,0
153870318,ᵀᴱMolotofFR,ᵀᴱMolotofFR,[1/TE]Twilight~Errant,[1/TE]Twilight~Errant,57,57,0,35289910,35294882,4972,93926338,93926338,0,1400649,1400649,0,339200000,339200000,0,7994577,7994577,0,7994577,574398,0
147292764,ᴶᵀRinaldo,ᴶᵀRinaldo,[31Ws]Whisky & Soda,[31Ws]Whisky & Soda,58,74,16,33806185,33192749,-613436,98464113,101011263,2547150,949205,1042432,93227,293521369,293521369,0,8542964,8654627,111663,8542964,454582,71526
148908873,ROAC the great,ROAC the great,[31Ws]Whisky & Soda,[31Ws]Whisky & Soda,59,62,3,34619952,34212924,-407028,68366378,72272830,3906452,485184,622610,137426,20701996,20701996,0,5505776,5830400,324624,5505776,527363,32984
107920162,botoamazonico,botoamazonico,[31Ws]Whisky & Soda,[31Ws]Whisky & Soda,60,59,-1,35003711,34954157,-49554,16201773,16320803,119030,3304427,3351273,46846,14108627,14108627,0,892656,901209,8553,892656,190705,1675
145434888,ᵀᴱmbahpacul,ᵀᴱmbahpacul,[1/TE]Twilight~Errant,[8/TE]Farmer and AOO,61,58,-3,34923782,35113386,189604,166000,166553476,166387476,1148573,1148573,0,2690916523,2690916523,0,12797593,12828231,30638,12797593,368987,80
153442251,ᵀᴱLTP,ᵀᴱLTP,[1/TE]Twilight~Errant,[1/TE]Twilight~Errant,62,61,-1,34858479,34858479,0,134099,134099622,133965523,661047,661047,0,47366899,47366899,0,10706924,10706924,0,10706924,336185,0
142906125,ᵀᴱGia Long,ᵀᴱGia Long,[1/TE]Twilight~Errant,[1/TE]Twilight~Errant,63,60,-3,34883477,34870501,-12976,195029,195029235,194834206,1260663,1260663,0,33268661,33268661,0,16134267,16134267,0,16134267,1085194,0
153120638,ᴼᴹTrajan,ᴼᴹTrajan,[OM/1]OGAH MUNDURR,[OM/1]OGAH MUNDURR,64,63,-1,34164868,34219868,55000,89580115,89580115,0,2692664,2692664,0,582976180,582976180,0,7243638,7243638,0,7243638,762318,0
146478339,ᵀᴱsᴀɴᴏ,ᵀᴱsᴀɴᴏ,[JH31]JANDA HUNTER XV,[31Ws]Whisky & Soda,65,65,0,33983418,34062585,79167,94983010,96308510,1325500,1840748,1840748,0,250022839,250022839,0,7535377,7664415,129038,7535377,822475,1756
146504151,ᵀᴱ Killua,ᵀᴱ Killua,[1/TE]Twilight~Errant,[1/TE]Twilight~Errant,66,66,0,33909151,33711727,-197424,218881,220815995,220597114,2139837,2150443,10606,2066585050,2066585050,0,15459894,15633940,174046,15459894,1280595,9237
137717946,ᵀᴱSCØRPIØ,ᵀᴱSCØRPIØ,[1/TE]Twilight~Errant,[1/TE]Twilight~Errant,67,68,1,33790653,33560250,-230403,205868,208567519,208361651,1868783,1868783,0,421656709,421656709,0,15700902,15879076,178174,15700902,2323177,45848
150920711,ᴳᵇ H,ᴳᵇ H,[31Ws]Whisky & Soda,[31Ws]Whisky & Soda,68,81,13,33509065,32301313,-1207752,32302167,34133697,1831530,532340,731270,198930,29786129,29786129,0,2317152,2473295,156143,2317152,126297,13505
145380705,Quang TX,Quang TX,[1/TE]Twilight~Errant,[1/TE]Twilight~Errant,69,67,-2,33562534,33609214,46680,37577120,38124540,547420,491745,491745,0,104438343,104438343,0,2559401,2600189,40788,2559401,481192,6977
151184418,ʷˢ Martyr,ʷˢ Martyr,[31Ws]Whisky & Soda,[31Ws]Whisky & Soda,70,71,1,33444737,33445145,408,32052985,32052985,0,423053,423053,0,4238966,4238966,0,2304145,2304145,0,2304145,370290,0
147688583,Unus Sed Leo,Unus Sed Leo,[31Ws]Whisky & Soda,[31Ws]Whisky & Soda,71,75,4,33423547,33007475,-416072,65567350,68947634,3380284,1194949,1268573,73624,340626487,340626487,0,5537355,745902,-4791453,5537355,440642,64920
150024965,ᴼᵐKey,ᴼᵐKey,[OM/1]OGAH MUNDURR,[OM/1]OGAH MUNDURR,72,70,-2,33415271,33455579,40308,262586,263908702,263646116,2013556,2013556,0,157556477,157556477,0,22446771,22446771,0,22446771,1302271,0
145183229,ᵀᴱChimƯng,ᵀᴱChimƯng,[1/TE]Twilight~Errant,[1/TE]Twilight~Errant,73,73,0,33502359,33365223,-137136,135018,135649519,135514501,2017301,2062521,45220,33005007,33005007,0,9356430,9390379,33949,9356430,1634090,14574
146489118,ᵏˢメKieferメ,ᵏˢメKieferメ,[1/TE]Twilight~Errant,[1/TE]Twilight~Errant,74,69,-5,33251034,33458271,207237,225014,225464941,225239927,1400344,1411042,10698,1121342323,1121342323,0,17028322,17070692,42370,17028322,1938408,979
148646461,bluelixr,bluelixr,[31Ws]Whisky & Soda,[31Ws]Whisky & Soda,75,72,-3,33389560,33399724,10164,30360476,30360476,0,236715,236715,0,42998477,42998477,0,2336885,2336885,0,2336885,288238,0
133036618,PéNhi2k11,PéNhi2k11,[3mls]Gg31zzz,[3mls]Gg31zzz,76,76,0,33067705,32917270,-150435,1220404,1238377521,1237157117,7198524,7198524,0,3984195643,3984195643,0,91381803,92519658,1137855,91381803,4334304,32821
153063772,SniperBarbie,SniperBarbie,#error#,#error#,77,77,0,32901857,32901857,0,50088378,50088378,0,618785,618785,0,105467743,105467743,0,4185117,4185117,0,4185117,281500,0
148912035,Whitebeard ace,Whitebeard ace,[31Ws]Whisky & Soda,[31Ws]Whisky & Soda,78,95,17,32706368,30970918,-1735450,65007172,67267612,2260440,939838,1102537,162699,108751236,108751236,0,5464613,5620637,156024,5464613,409272,35010
150001642,ᴼᵐDaniel 박,ᴼᵐDaniel 박,[1/TE]Twilight~Errant,[1/TE]Twilight~Errant,79,78,-1,32566121,32765781,199660,153398,153398394,153244996,633533,633533,0,407398056,407398056,0,13553700,13553700,0,13553700,654361,0
146470372,BLØODSEEKER,BLØODSEEKER,[OM/1]OGAH MUNDURR,[1/TE]Twilight~Errant,80,80,0,32542594,32412125,-130469,229541,230508999,230279458,1728051,1738749,10698,204840090,209840090,5000000,17714769,17793351,78582,17714769,2333519,8704
150987751,Traven81,Traven81,[OM/1]OGAH MUNDURR,[OM/1]OGAH MUNDURR,81,83,2,32220871,32220871,0,13482465,13482465,0,468035,468035,0,3685077,3685077,0,-1,1139175,1139176,-1,55650,0
148824756,ʷˢNicktroops,ʷˢNicktroops,[31Ws]Whisky & Soda,[31Ws]Whisky & Soda,82,82,0,32219319,32234507,15188,51634677,51634677,0,862710,862710,0,455252563,495252563,40000000,3912889,3912889,0,3912889,295304,0
153064413,ᵀᴱAdkel,ᵀᴱAdkel,[1/TE]Twilight~Errant,[1/TE]Twilight~Errant,83,79,-4,32438321,32449129,10808,193257,193257066,193063809,1048005,1048005,0,587151478,587151478,0,13590613,13590613,0,13590613,1750796,0
150365161,ʷˢ FokuSmok,ʷˢ FokuSmok,[31Ws]Whisky & Soda,[31Ws]Whisky & Soda,84,84,0,32172812,32172812,0,70630651,70642841,12190,1051283,1051283,0,5860609,5860609,0,4843761,4844980,1219,4843761,376735,0
150156415,ᵀᴱメShin,ᵀᴱメShin,[1/TE]Twilight~Errant,[1/TE]Twilight~Errant,85,86,1,32056332,32067390,11058,396886,397946480,397549594,1334840,1334840,0,515189819,515189819,0,28400943,28478984,78041,28400943,919283,13876
148671114,ᴷᵂZanmage,ᴷᵂZanmage,[31Ws]Whisky & Soda,[31Ws]Whisky & Soda,86,109,23,31047140,29919192,-1127948,127395,131268640,131141245,1224484,1342590,118106,495218609,495218609,0,10276966,10578566,301600,10276966,434830,42578
145474458,ᵀᴱTIGER,ᵀᴱTIGER,[1/TE]Twilight~Errant,[1/TE]Twilight~Errant,87,64,-23,32123799,34116975,1993176,285532,285532655,285247123,1288890,1288890,0,806901537,806901537,0,21855283,21855283,0,21855283,2323564,0
151203118,ᴳᵇGiovixTV,ᴳᵇGiovixTV,[31Ws]Whisky & Soda,[31Ws]Whisky & Soda,88,87,-1,31776569,31782569,6000,35952338,35952338,0,1071709,1071709,0,65234013,65234013,0,2075959,2075959,0,2075959,30192,0
148021447,ᵀᴱmasew,ᵀᴱmasew,[1/TE]Twilight~Errant,[1/TE]Twilight~Errant,89,85,-4,31757498,32092206,334708,169408,169700149,169530741,982151,982151,0,852433713,852433713,0,13392162,13395056,2894,13392162,986231,13135
133447742,ᴼᴹ Héo úa,ᴼᴹ Héo úa,[OM/1]OGAH MUNDURR,[OM/1]OGAH MUNDURR,90,88,-2,31530699,31530699,0,70622372,70622372,0,1959557,1959557,0,416832396,416832396,0,5987643,5987643,0,5987643,85052,0
153024283,ᵀᴱSdh17,ᵀᴱSdh17,#error#,#error#,91,89,-2,31488235,31488235,0,56431045,56431045,0,359144,359144,0,1147500,1147500,0,4898087,4898087,0,4898087,218070,0
153794218,ᵀᴱ Độ,ᵀᴱ Độ,[1/TE]Twilight~Errant,[1/TE]Twilight~Errant,92,98,6,31433964,30803110,-630854,49063428,49899560,836132,1365314,1480204,114890,15190663,15190663,0,3683459,3731985,48526,3683459,438241,17532
152975039,Dipota eh,Dipota eh,[OM/1]OGAH MUNDURR,[OM/1]OGAH MUNDURR,93,90,-3,31240268,31273400,33132,189831,189831156,189641325,1537081,1537081,0,85872138,85872138,0,16376762,16376762,0,16376762,898828,0
153753743,ᵀᴱ冷cool,ᵀᴱ冷cool,[1/TE]Twilight~Errant,[1/TE]Twilight~Errant,94,93,-1,31148935,31030706,-118229,112956,115800163,115687207,1051251,1083521,32270,110800000,110800000,0,8854075,8948658,94583,8854075,1232129,94912
145278788,seb01sangt,seb01sangt,[31Gp]GOLDEN PHOENIX,[31Gp]GOLDEN PHOENIX,95,92,-3,31084132,31119732,35600,5885564,5885564,0,499535,499535,0,54882437,54882437,0,460085,460085,0,460085,50747,0
153658450,ᵀᴱ Lavel,ᵀᴱ Lavel,[1/TE]Twilight~Errant,[1/TE]Twilight~Errant,96,108,12,30864577,30280272,-584305,217686,218280899,218063213,1249714,1556993,307279,189036546,189036546,0,19026749,19065439,38690,19026749,853336,10051
147797903,义King Hunt,义King Hunt,[OM/1]OGAH MUNDURR,[OM/1]OGAH MUNDURR,97,91,-6,30917306,31155062,237756,124276,124276894,124152618,1424064,1424064,0,2501545126,2501545130,4,9204086,9204086,0,9204086,288220,0
147394675,ᵀᴱ ChronoZ㋳,ᵀᴱ ChronoZ㋳,[1/TE]Twilight~Errant,[1/TE]Twilight~Errant,98,96,-2,30782165,30894389,112224,104124,105050111,104945987,3171434,3171434,0,439951796,439951796,0,7995761,8056613,60852,7995761,251124,228
153402134,CocoCarott,CocoCarott,[1/TE]Twilight~Errant,[1/TE]Twilight~Errant,99,99,0,30678684,30712128,33444,92873864,94871914,1998050,1169719,1170793,1074,1280829990,1300829990,20000000,7343695,7474426,130731,7343695,843298,34537
153068178,33 Poseidon 33,33 Poseidon 33,[31/P] Peace Rulers,[31/P] Peace Rulers,100,100,0,30558823,30558823,0,7939856,7939856,0,187428,187428,0,0,0,0,395834,395834,0,395834,27442,0
150630696,Ф Red Ф,Ф Red Ф,[31Ws]Whisky & Soda,[31Ws]Whisky & Soda,101,101,0,30428902,30451254,22352,23100301,23100301,0,277453,277453,0,37161999,37161999,0,1708054,1708054,0,1708054,37868,0
153444161,ᵀᴱFeanor,ᵀᴱFeanor,[1/TE]Twilight~Errant,[1/TE]Twilight~Errant,102,102,0,30396604,30422604,26000,22755002,22755002,0,628714,628714,0,0,0,0,1562887,1562887,0,1562887,289561,0
146828631,ʀᴏᴜɢᴇ,ʀᴏᴜɢᴇ,[OM/1]OGAH MUNDURR,[OM/1]OGAH MUNDURR,103,94,-9,30750136,31011647,261511,95738734,95738734,0,1604201,1604201,0,436040375,436040375,0,7981522,7981522,0,7981522,384376,0
150340845,Makadenis,Makadenis,[31Ws]Whisky & Soda,[31Ws]Whisky & Soda,104,97,-7,30429576,30871634,442058,25029514,25029514,0,171377,171377,0,6160000,6160000,0,1811086,1811086,0,1811086,326607,0
150320645,Nordi2,Nordi2,[31Ws]Whisky & Soda,[31Ws]Whisky & Soda,105,106,1,30354301,30354301,0,36202524,36202524,0,585998,585998,0,347519118,347519118,0,2157098,2157098,0,2157098,46576,0
146827716,ᴼᴹ Wz,ᴼᴹ Wz,[OM/1]OGAH MUNDURR,[OM/1]OGAH MUNDURR,106,104,-2,30357062,30383430,26368,67895487,67895487,0,518566,518566,0,132133032,132133032,0,-1,3542042,3542043,-1,149936,0
147655834,Deliverance,Deliverance,[31Ws]Whisky & Soda,[31Ws]Whisky & Soda,107,114,7,30023834,29416857,-606977,66078085,67260872,1182787,1155352,1359156,203804,60215982,60215982,0,5268146,5364315,96169,5268146,270915,10989
145193499,ᵀᴱᵀᴱx,ᵀᴱᵀᴱx,[1/TE]Twilight~Errant,[1/TE]Twilight~Errant,108,105,-3,30358191,30361927,3736,128946,128946852,128817906,1134029,1134029,0,1112007149,1112007149,0,9946424,9946424,0,9946424,401072,0
115251624,亗SANDOVAL亗,亗SANDOVAL亗,[1/TE]Twilight~Errant,[1/TE]Twilight~Errant,109,107,-2,30058220,30296276,238056,20568160,20769560,201400,2933150,2933150,0,1185091483,1185091483,0,1375195,1383777,8582,1375195,246636,5779
145664378,ᴳᵇ Kazakh,ᴳᵇ Kazakh,[1/TE]Twilight~Errant,[31Ws]Whisky & Soda,110,103,-7,29940132,30408240,468108,41452833,41452833,0,1635150,1635150,0,162204877,162204877,0,2421147,2421147,0,2421147,207266,0
153512273,ᵀᴱ Emma,ᵀᴱ Emma,[1/TE]Twilight~Errant,[1/TE]Twilight~Errant,111,116,5,29771864,29332521,-439343,283939,288102496,287818557,1584842,1653021,68179,286494828,286494828,0,-1,24491791,24491792,-1,1136006,32668
148639257,Cypherist,Cypherist,[31Ws]Whisky & Soda,[31Ws]Whisky & Soda,112,126,14,29653039,28795749,-857290,11410539,11835907,425368,747813,970301,222488,26047205,26047205,0,937175,967522,30347,937175,77091,6092
145846699,ᵀᴱAah,ᵀᴱAah,[1/TE]Twilight~Errant,[1/TE]Twilight~Errant,113,110,-3,30012381,29802314,-210067,391007,393587059,393196052,2214089,2214089,0,738816429,738816429,0,31995847,31245915,-749932,31995847,1989635,0
147786314,ᶻᵉBonekamp,ᶻᵉBonekamp,[31Ws]Whisky & Soda,[31Ws]Whisky & Soda,114,115,1,28172553,29372040,1199487,63671896,64411006,739110,1178590,1226336,47746,37815071,37815071,0,4317229,4348786,31557,4317229,418146,21177
153739110,LimBanSoek,LimBanSoek,[1/TE]Twilight~Errant,[1/TE]Twilight~Errant,115,127,12,29543576,28781604,-761972,124525,125672442,125547917,957191,968984,11793,18493682,18493682,0,10350371,10386601,36230,10350371,880537,39225
150312801,ᵍᵇ P,ᵍᵇ P,[31Ws]Whisky & Soda,[31Ws]Whisky & Soda,116,112,-4,29534182,29632178,97996,20888733,20888733,0,71087,71087,0,198880450,198880450,0,1605772,1605772,0,1605772,37300,0
145500916,ᵀᴶ Marna,ᵀᴶ Marna,[1/TE]Twilight~Errant,[1/TE]Twilight~Errant,117,119,2,29576297,29148431,-427866,111938,113606950,113495012,1106414,1224040,117626,628312721,638312721,10000000,7549948,7687952,138004,7549948,1665732,14370
154281611,ᴼᴹ FYNnnn,ᴼᴹ FYNnnn,[OM/1]OGAH MUNDURR,[OM/1]OGAH MUNDURR,118,111,-7,29507879,29793656,285777,95355700,98546906,3191206,653962,678785,24823,178298362,178298362,0,8507128,8793157,286029,8507128,455355,16537
153415389,Pak Radens,Pak Radens,[1/TE]Twilight~Errant,[1/TE]Twilight~Errant,119,117,-2,29292078,29292078,0,74814864,74814864,0,883512,883512,0,1800000,1800000,0,6042126,6042126,0,6042126,578080,0
147671009,ᶻᵉPixie,ᶻᵉPixie,[31Ws]Whisky & Soda,[31Ws]Whisky & Soda,120,135,15,29263361,28292917,-970444,53716781,57663647,3946866,967918,1170286,202368,348605870,348605870,0,4063597,4368661,305064,4063597,573010,44811
150393095,ᴳᵇ   M,ᴳᵇ   M,[31Ws]Whisky & Soda,[1/TE]Twilight~Errant,121,124,3,29188058,28908042,-280016,11335077,11399927,64850,168025,168025,0,10103800,10103800,0,902781,908222,5441,902781,44298,522
145931672,ᵀᴱ exalted,ᵀᴱ exalted,[1/TE]Twilight~Errant,[1/TE]Twilight~Errant,122,113,-9,29374075,29588787,214712,284499,285812918,285528419,2108344,2108344,0,662489209,662489209,0,22545610,22632472,86862,22545610,1653626,0
145509893,Ба乂 亗,Ба乂 亗,[JH31]JANDA HUNTER XV,[JH31]JANDA HUNTER XV,123,120,-3,29056274,29084290,28016,111403,111403263,111291860,1814350,1814350,0,1679067017,1679067017,0,7279565,7279565,0,7279565,556523,0
147692426,ᶻᵉ Sarawr,ᶻᵉ Sarawr,[31Ws]Whisky & Soda,[31Ws]Whisky & Soda,124,121,-3,29031613,29031613,0,67611785,67611785,0,1603288,1603288,0,634617876,634617876,0,5355873,5355873,0,5355873,389323,0
147711559,ᶻᵉLouis,ᶻᵉLouis,[31Ws]Whisky & Soda,[31Ws]Whisky & Soda,125,122,-3,28959029,28986429,27400,107279,107279892,107172613,999603,999603,0,54632670,54632670,0,8712326,8712326,0,8712326,669101,0
150673323,Geøø,Geøø,[31Ws]Whisky & Soda,[31Ws]Whisky & Soda,126,123,-3,28925670,28947570,21900,64258829,64258829,0,1013654,1013654,0,193290887,193290887,0,4744769,4744769,0,4744769,367845,0
145733396,ᵀᴱ Long,ᵀᴱ Long,[1/TE]Twilight~Errant,[1/TE]Twilight~Errant,127,118,-9,29080751,29176277,95526,94940153,94940153,0,2059710,2059710,0,61135766,61135766,0,7370879,7370879,0,7370879,930238,0
153237820,ᵀᴱMonjaro,ᵀᴱMonjaro,#error#,#error#,128,128,0,28779768,28779768,0,38844722,38844722,0,380585,380585,0,77074258,77074258,0,2639304,2639304,0,2639304,143783,0
148884538,ʷˢDamsorrr,ʷˢDamsorrr,[31Ws]Whisky & Soda,[31Ws]Whisky & Soda,129,138,9,28090325,28131974,41649,35220372,35220372,0,587095,587095,0,80732753,80732753,0,2429511,2429511,0,2429511,431256,0
151185639,ʷˢ ʒupi,ʷˢ ʒupi,[31Ws]Whisky & Soda,[31Ws]Whisky & Soda,130,133,3,28711725,28477089,-234636,16598684,17541426,942742,505389,579130,73741,60663480,60663480,0,1203235,1277935,74700,1203235,133110,9703
147638142,ᴱᴳClang2023,ᴱᴳClang2023,#error#,#error#,131,130,-1,28689423,28689423,0,27739773,27739773,0,1404617,1404617,0,198112260,198112260,0,2170972,2170972,0,2170972,65933,0
148702828,brayan alva,brayan alva,[31Ws]Whisky & Soda,[31Ws]Whisky & Soda,132,129,-3,28683805,28715393,31588,29519065,29519065,0,170432,170432,0,64000000,64000000,0,2139396,2139396,0,2139396,37848,0
148983243,world04,world04,[31Ws]Whisky & Soda,[31Ws]Whisky & Soda,133,166,33,26983319,26628315,-355004,75190663,78055903,2865240,1029356,1065493,36137,74589868,74589868,0,6117552,6294020,176468,6117552,528329,55028
153834453,ᵀ黑老大ᴱ,ᵀ黑老大ᴱ,[1/TE]Twilight~Errant,[1/TE]Twilight~Errant,134,125,-9,28653499,28906478,252979,37595888,37595888,0,411087,411087,0,278806876,278806876,0,2958713,2958713,0,2958713,350971,0
147703092,ᶻᵉCaracas,ᶻᵉCaracas,[31Ws]Whisky & Soda,[31Ws]Whisky & Soda,135,150,15,28321184,27297836,-1023348,36619711,37347201,727490,1164498,1274629,110131,40029756,40029756,0,2919628,2972737,53109,2919628,263337,9820
153212015,ᴼᵐHayhy,ᴼᵐHayhy,[OM/1]OGAH MUNDURR,[OM/1]OGAH MUNDURR,136,131,-5,28619464,28666638,47174,91266537,91266537,0,1042135,1042135,0,13200000,13200000,0,7590022,7590022,0,7590022,384622,0
146771051,ᴼᵐAybeee,ᴼᵐAybeee,[OM/1]OGAH MUNDURR,[OM/1]OGAH MUNDURR,137,132,-5,28487233,28494393,7160,112990,112990849,112877859,821801,821801,0,254066219,254066219,0,8681217,8681217,0,8681217,579795,0
151238052,ᴳᵇOhga,ᴳᵇOhga,[31Ws]Whisky & Soda,[31Ws]Whisky & Soda,138,137,-1,28168014,28168014,0,1551909,1551909,0,14370,14370,0,0,0,0,126989,126989,0,126989,0,0
147764296,ɢᴏᴇɴᴛ,ɢᴏᴇɴᴛ,[OM/1]OGAH MUNDURR,[OM/1]OGAH MUNDURR,139,134,-5,28189436,28253356,63920,33274137,33274137,0,676057,676057,0,89639814,99639814,10000000,2845820,2845820,0,2845820,103024,0
145311443,ᵀᴱZegion,ᵀᴱZegion,[1/TE]Twilight~Errant,[1/TE]Twilight~Errant,140,136,-4,28207794,28213550,5756,110338,110338168,110227830,2182524,2182524,0,71485376,71485376,0,7902232,7902232,0,7902232,1212743,0
146791976,ᴼᵐKill,ᴼᵐKill,[OM/1]OGAH MUNDURR,[OM/1]OGAH MUNDURR,141,139,-2,28065874,28079878,14004,222882,224080431,223857549,1052821,1052821,0,139516452,139516452,0,17261891,17377713,115822,17261891,742772,0
147674965,ᶻᵉ wisey,ᶻᵉ wisey,[31Ws]Whisky & Soda,[31Ws]Whisky & Soda,142,143,1,27923371,27596018,-327353,42386414,43424324,1037910,1172015,1214722,42707,118638511,118638511,0,3445543,3537852,92309,3445543,150100,5741
147705182,ᶻᵉ Puchi,ᶻᵉ Puchi,[31Ws]Whisky & Soda,[31Ws]Whisky & Soda,143,155,12,27852838,27070912,-781926,40898160,41854070,955910,651183,651504,321,30683373,30683373,0,-1,3428915,3428916,-1,292961,17481
151123677,ᴳᵇTrinity,ᴳᵇTrinity,[31Ws]Whisky & Soda,[31Gp]GOLDEN PHOENIX,144,141,-3,27653545,27787928,134383,91361435,91361435,0,666261,666261,0,150352324,150352324,0,7552736,7552736,0,7552736,310747,0
1510322903,ᶠ2ᵖ R i c o,Your Reaper,[iR92]Squad Rajawali,[31Ws]Whisky & Soda,145,300,155,28024759,21103936,-6920823,62477639,13331463,-49146176,709218,704717,-4501,106731625,21520667,-85210958,4691073,717718,-3973355,4691073,253864,-297217
145379801,ᵀᴱ Tiger86,ᵀᴱ Tiger86,[1/TE]Twilight~Errant,[1/TE]Twilight~Errant,146,140,-6,27648618,28035829,387211,73415529,73415529,0,1784017,1784017,0,1415218506,1415218506,0,5375928,5375928,0,5375928,584755,0
153191024,๓؎q؎hєى㋡,๓؎q؎hєى㋡,[1/TE]Twilight~Errant,[1/TE]Twilight~Errant,147,142,-5,27562151,27761487,199336,56741222,56752822,11600,1861714,1861714,0,0,0,0,4133763,4134923,1160,4133763,561501,0
153777690,MagicWillyChen,MagicWillyChen,[31Ws]Whisky & Soda,[31Ws]Whisky & Soda,148,149,1,27318826,27345026,26200,2658948,2658948,0,5541,5541,0,0,0,0,209097,209097,0,209097,4006,0
151139046,Nación Akachan,Nación Akachan,[31Ws]Whisky & Soda,[31Ws]Whisky & Soda,149,146,-3,27327371,27449451,122080,15823541,15826561,3020,337072,337072,0,3228994,3228994,0,1156684,1156986,302,1156684,192386,0
153581603,Brakraa,Brakraa,[31Ws]Whisky & Soda,[31Ws]Whisky & Soda,150,148,-2,27378476,27404976,26500,20482585,20482585,0,344092,344092,0,4165052,4165052,0,1771220,1771220,0,1771220,65429,0
147783278,ᴼᴹSudirman,ᴼᴹSudirman,[OM/1]OGAH MUNDURR,[OM/1]OGAH MUNDURR,151,145,-6,27232632,27486670,254038,25697312,25697312,0,340537,340537,0,44342039,44342039,0,2083220,2083220,0,2083220,179144,0
148280305,Little ant,Little ant,[31Ws]Whisky & Soda,[31Ws]Whisky & Soda,152,152,0,27223623,27223623,0,31020564,31020564,0,236978,236978,0,28999712,28999712,0,2250132,2250132,0,2250132,373610,0
150949512,ᴳᵇAnti3093,ᴳᵇAnti3093,[31Ws]Whisky & Soda,[31Ws]Whisky & Soda,153,165,12,27188285,26637335,-550950,51050309,52011699,961390,1152863,1152863,0,139233325,139233325,0,3962774,4034639,71865,3962774,216315,12137
146260904,ᵀᴱ Ivar,ᵀᴱ Ivar,[1/TE]Twilight~Errant,[1/TE]Twilight~Errant,154,144,-10,27482990,27495790,12800,43445023,43445023,0,1580315,1580315,0,627233179,627233179,0,3083996,3083996,0,3083996,360818,0
153453009,ᴼᵐKojiii,ᴼᵐKojiii,[OM/1]OGAH MUNDURR,[OM/1]OGAH MUNDURR,155,151,-4,27263853,27268853,5000,95948267,95948267,0,728415,728415,0,142236098,142236098,0,7538044,7538044,0,7538044,786117,0
145369488,ᵀᴱEarth,ᵀᴱEarth,[1/TE]Twilight~Errant,[1/TE]Twilight~Errant,156,153,-3,27087582,27200582,113000,73352809,73361909,9100,1316157,1316157,0,513537560,513537560,0,5237981,5238891,910,5237981,211855,0
153332585,E҉L҉A҉N҉G,E҉L҉A҉N҉G,[1/TE]Twilight~Errant,[1/TE]Twilight~Errant,157,154,-3,27024284,27184201,159917,81192279,81192279,0,809527,809527,0,6920242,6920242,0,6542202,6542202,0,6542202,602196,0
145426027,1AmS1n9leN0w,1AmS1n9leN0w,[OM/1]OGAH MUNDURR,[OM/1]OGAH MUNDURR,158,156,-2,27010318,27019618,9300,58958936,58958936,0,1545812,1545812,0,178380022,178380022,0,3649868,3649868,0,3649868,1057632,0
153726841,ᴼᵐGecho23,ᴼᵐGecho23,[OM/1]OGAH MUNDURR,[OM/1]OGAH MUNDURR,159,147,-12,26956542,27431494,474952,77046658,77046658,0,1106236,1106236,0,850909818,850909818,0,6217859,6217859,0,6217859,645553,0
153065083,ᵀᴱMachine,ᵀᴱMachine,[1/TE]Twilight~Errant,[1/TE]Twilight~Errant,160,180,20,27061760,25808563,-1253197,40964953,42022733,1057780,1586505,1586505,0,10000000,10000000,0,3026713,3074637,47924,3026713,480203,28927
145199026,Viking07200,Viking07200,[31Ws]Whisky & Soda,[31Ws]Whisky & Soda,161,157,-4,26905540,26921540,16000,3154536,3154536,0,97323,97323,0,1455481,1455481,0,290396,290396,0,290396,6479,0
153772676,ᵀᴱ TùGnNè,ᵀᴱ TùGnNè,[1/TE]Twilight~Errant,[1/TE]Twilight~Errant,162,164,2,26808827,26640362,-168465,77175335,80822688,3647353,1294973,1352048,57075,126281512,126281512,0,5403920,5688970,285050,5403920,578331,38877
147358260,亗 Gatopelon,亗 Gatopelon,[1/TE]Twilight~Errant,[1/TE]Twilight~Errant,163,158,-5,26739707,26739707,0,76421083,76421083,0,1456605,1456605,0,340844605,340844605,0,5822870,5822870,0,5822870,663023,0
145313694,乂I m Sorry乂,乂I m Sorry乂,[OM/1]OGAH MUNDURR,[OM/1]OGAH MUNDURR,164,160,-4,26668063,26668063,0,426536,426536204,426109668,3321138,3321138,0,2300042306,2300042306,0,35257163,35257163,0,35257163,2687310,0
140780709,ᵀᴱQuang,ᵀᴱQuang,[1/TE]Twilight~Errant,[1/TE]Twilight~Errant,165,162,-3,26718588,26654388,-64200,195910,197133469,196937559,2369925,2421220,51295,593020992,623020992,30000000,13395797,13454001,58204,13395797,1173574,32036
151092910,Al3xPortugal,Al3xPortugal,[1/TE]Twilight~Errant,[1/TE]Twilight~Errant,166,159,-7,26649989,26673297,23308,25653396,25653396,0,632813,632813,0,5000000,5000000,0,1723627,1723627,0,1723627,392828,0
153242155,ᵀᴱMankichiツ,ᵀᴱMankichiツ,[1/TE]Twilight~Errant,[1/TE]Twilight~Errant,167,163,-4,26629149,26651549,22400,113650,113650565,113536915,1188505,1188505,0,1548000,1548000,0,8315187,8315187,0,8315187,860228,0
147375233,ᴸᴴ Put,ᴸᴴ Put,#error#,#error#,168,167,-1,26601243,26601243,0,63528298,63528298,0,1532632,1532632,0,464926939,464926939,0,4520130,4520130,0,4520130,795372,0
153089645,vckrbrn 3131,Your Reaper,#error#,[31Ws]Whisky & Soda,169,300,131,26584197,21103936,-5480261,35416016,13331463,-22084553,272440,704717,432277,19600000,21520667,1920667,2903555,717718,-2185837,2903555,253864,33504
149710423,ᵀᴱ Мот,ᵀᴱ Мот,[1/TE]Twilight~Errant,[1/TE]Twilight~Errant,170,169,-1,26604226,26398649,-205577,141267,141291896,141150629,1729640,1729640,0,710137508,710137508,0,11232492,11234960,2468,11232492,926334,0
151081037,ᴼᴹRakaRaika,ᴼᴹRakaRaika,[1/TE]Twilight~Errant,[1/TE]Twilight~Errant,171,185,14,26458638,25473378,-985260,97706352,98645592,939240,1633599,1646512,12913,143770141,143770141,0,7227075,7261651,34576,7227075,863316,29674
153415907,ᴼᴹMiracle,ᴼᴹMiracle,[OM/1]OGAH MUNDURR,[OM/1]OGAH MUNDURR,172,161,-11,26629255,26663755,34500,90505148,90507788,2640,1765609,1765609,0,388724411,488724411,100000000,-1,7585759,7585760,-1,410506,0
151239271,ʷˢAlexᵇʸツ,ʷˢAlexᵇʸツ,[31Ws]Whisky & Soda,[31Ws]Whisky & Soda,173,170,-3,26438302,26354586,-83716,51749153,52096903,347750,943953,977641,33688,152516323,152516323,0,3318131,3346604,28473,3318131,149771,3151
151177308,ちゃあ,ちゃあ,[31Ws]Whisky & Soda,[31Ws]Whisky & Soda,174,171,-3,26178631,26271534,92903,14585910,14585910,0,815388,815388,0,151000000,151000000,0,941005,941005,0,941005,97155,0
145307332,ᵀᴱ Ötzi,ᵀᴱ Ötzi,[1/TE]Twilight~Errant,[1/TE]Twilight~Errant,175,186,11,26164960,25469972,-694988,110606,112937286,112826680,1782785,1835069,52284,27095197,27095197,0,7595351,7714933,119582,7595351,1506144,56720
145663656,ʊʀEvil sky,ʊʀEvil sky,[OM/1]OGAH MUNDURR,[OM/1]OGAH MUNDURR,176,174,-2,26112336,26138349,26013,120394,120394460,120274066,1643159,1643159,0,260035487,260035487,0,8923085,8923085,0,8923085,972983,0
148937485,Satan627,Satan627,[31Ws]Whisky & Soda,[31Ws]Whisky & Soda,177,168,-9,26097567,26500331,402764,31710666,31710666,0,541480,541480,0,44118890,44118890,0,2753544,2753544,0,2753544,168153,0
151057279,ʷˢ Kツ,ʷˢ Kツ,[31Ws]Whisky & Soda,[31Ws]Whisky & Soda,178,173,-5,26004787,26158093,153306,226229,227464742,227238513,2567761,2572126,4365,407321904,407321904,0,18483588,18591173,107585,18483588,1169676,7987
145879767,ᵀᴱRtB PLKN,ᵀᴱRtB PLKN,[1/TE]Twilight~Errant,[1/TE]Twilight~Errant,179,175,-4,25994698,26001498,6800,61975138,61975138,0,1326804,1326804,0,124930510,124930510,0,4517549,4517549,0,4517549,640482,0
152977408,ᵀᴱACE,ᵀᴱACE,[1/TE]Twilight~Errant,[1/TE]Twilight~Errant,180,178,-2,25868877,25887904,19027,153612,153641922,153488310,1209021,1209021,0,231013843,231013843,0,11570215,11573108,2893,11570215,1233243,0
147668144,ᶻᵉMoon,ᶻᵉMoon,[31Ws]Whisky & Soda,[31Ws]Whisky & Soda,181,179,-2,25824571,25878407,53836,32124896,33061486,936590,466532,503024,36492,198955181,198955181,0,1506565,2582582,1076017,1506565,195019,8821
153656948,ᵀᴱ NittyXx,ᵀᴱ NittyXx,[1/TE]Twilight~Errant,[1/TE]Twilight~Errant,182,177,-5,25809928,25910283,100355,114748,114770984,114656236,2008848,2008848,0,672800000,672800000,0,8510843,8513132,2289,8510843,920006,0
151146853,Snùff,Snùff,[31Ws]Whisky & Soda,[31Ws]Whisky & Soda,183,172,-11,25293424,26166315,872891,36147851,36237110,89259,156985,158840,1855,93190458,93190458,0,3152804,3159227,6423,3152804,200586,1197
151360006,ᴼᵐRes,ᴼᵐRes,[OM/1]OGAH MUNDURR,[OM/1]OGAH MUNDURR,184,181,-3,25767549,25777249,9700,35475382,35475382,0,749081,749081,0,711747410,711747410,0,2670103,2670103,0,2670103,398825,0
150237338,ᴳᵇ Iguana,ᴳᵇ Iguana,[31Ws]Whisky & Soda,[31Ws]Whisky & Soda,185,182,-3,25629788,25676250,46462,78024684,78024684,0,595324,595324,0,50487680,50487680,0,6751779,6751779,0,6751779,461984,0
153200286,ᴼᵐBLINKSTN,ᴼᵐBLINKSTN,[OM/1]OGAH MUNDURR,[GV31]GLORIOS VICTORY,186,176,-10,25696928,25915036,218108,52789225,52789225,0,530289,530289,0,4400000,4400000,0,4068258,4068258,0,4068258,369837,0
150244296,ᴷᴶ KoDoK,ᴷᴶ KoDoK,[OM/1]OGAH MUNDURR,[OM/1]OGAH MUNDURR,187,184,-3,25556847,25564347,7500,79951268,79951268,0,1558865,1558865,0,185749732,185749732,0,5734469,5734469,0,5734469,863294,0
145717778,Mamank 乄 31,Mamank 乄 31,[1/TE]Twilight~Errant,[1/TE]Twilight~Errant,188,183,-5,25425069,25581608,156539,94542048,94542048,0,2787161,2787161,0,230541517,230541517,0,6513459,6513459,0,6513459,627704,0
153401189,ᵀᴱ Nhím,ᵀᴱ Nhím,#error#,#error#,189,188,-1,25370443,25370443,0,81156749,81156749,0,2344768,2344768,0,248898917,248898917,0,6539491,6539491,0,6539491,186904,0
152965852,ᵀᴱBen XT,ᵀᴱBen XT,[1/TE]Twilight~Errant,[1/TE]Twilight~Errant,190,187,-3,25363350,25387766,24416,63786637,63786637,0,465431,465431,0,52169162,52169162,0,4493479,4493479,0,4493479,452194,0
146828121,ᴼᴹ J҉o҉ey,ᴼᴹ J҉o҉ey,[OM/1]OGAH MUNDURR,[OM/1]OGAH MUNDURR,191,189,-2,25336539,25336539,0,65985841,65985841,0,948668,948668,0,214808752,214808752,0,5292788,5292788,0,5292788,304113,0
148696674,Yar4,Yar4,[31Ws]Whisky & Soda,[31Ws]Whisky & Soda,192,190,-2,25291449,25313449,22000,71103732,71103732,0,1388980,1388980,0,1337482,1337482,0,5506053,5506053,0,5506053,693719,0
153810775,CuongC,CuongC,[1/TE]Twilight~Errant,[OM/E]familyOM~,193,196,3,25328102,24813690,-514412,58272400,59113678,841278,386776,399560,12784,0,0,0,4534536,4595115,60579,4534536,583812,11770
148622452,YARRRshin,YARRRshin,[31Ws]Whisky & Soda,[31Ws]Whisky & Soda,194,222,28,25153348,24069080,-1084268,15633419,16570109,936690,241922,378123,136201,23608482,23608482,0,1204922,1281315,76393,1204922,102996,8638
153068388,ᵀᴱ YuYu,ᵀᴱ YuYu,[1/TE]Twilight~Errant,[1/TE]Twilight~Errant,195,191,-4,25146898,25152898,6000,15372525,15372525,0,797163,797163,0,226922480,226922480,0,910668,910668,0,910668,284766,0
150219718,ˢᵍWisey95,ˢᵍWisey95,[31Ws]Whisky & Soda,[31Ws]Whisky & Soda,196,207,11,24963684,24770624,-193060,27214037,29147217,1933180,783889,839154,55265,92340295,92340295,0,2201382,2354932,153550,2201382,227492,19884
151216582,ʷˢl0renz0p,ʷˢl0renz0p,[31Ws]Whisky & Soda,[31Ws]Whisky & Soda,197,215,18,24857630,24279565,-578065,14118551,15479921,1361370,122292,145568,23276,65631921,65631921,0,1173203,1284968,111765,1173203,54853,12186
153284099,ᵀᴱGawrShark,ᵀᴱGawrShark,[31Ws]Whisky & Soda,[31Ws]Whisky & Soda,198,193,-5,24845177,24874253,29076,45893244,45893244,0,583052,583052,0,14343548,14343548,0,2728909,2728909,0,2728909,384144,0
149831176,ᵀᴱitsme๛M,ᵀᴱitsme๛M,[1/TE]Twilight~Errant,[1/TE]Twilight~Errant,199,194,-5,24842764,24869020,26256,73157245,73157245,0,1747959,1747959,0,1023942462,1023942462,0,6303427,6303427,0,6303427,281666,0
147627931,ᶻᵉREDW3020,ᶻᵉREDW3020,[31Ws]Whisky & Soda,[31Ws]Whisky & Soda,200,227,27,24767320,23984440,-782880,9358595,10233855,875260,324137,324137,0,5428285,5428285,0,636230,722342,86112,636230,137012,707
153201123,PvPlayer,PvPlayer,[OM/1]OGAH MUNDURR,[OM/1]OGAH MUNDURR,201,198,-3,24738273,24738273,0,172997,172997181,172824184,1182565,1182565,0,19828916,19828916,0,-1,12359298,12359299,-1,192988,0
153363673,ᵀᴱGàRừng,ᵀᴱGàRừng,[1/TE]Twilight~Errant,[1/TE]Twilight~Errant,202,210,8,24679724,24339148,-340576,102016,103737374,103635358,939168,1002391,63223,9600000,9600000,0,8020510,8126137,105627,8020510,1089603,33225
151201532,Kalin7,Kalin7,[31Ws]Whisky & Soda,[31Ws]Whisky & Soda,203,195,-8,24909706,24830343,-79363,26784942,27783992,999050,399161,399161,0,11600000,11600000,0,1783732,1815580,31848,1783732,262811,0
146690105,ᴼᴹ goelt,ᴼᴹ goelt,[JH31]JANDA HUNTER XV,[JH31]JANDA HUNTER XV,204,200,-4,24661694,24696922,35228,11462672,11462672,0,487454,487454,0,5728825,5728825,0,796988,796988,0,796988,144544,0
153732106,Magic dj,Magic dj,#error#,#error#,205,224,19,24533822,24015414,-518408,78684947,78788477,103530,927031,1018275,91244,102823300,102823300,0,6910368,6920721,10353,6910368,233444,0
154291041,ᵀᴱAnUBiS,ᵀᴱAnUBiS,[OM/1]OGAH MUNDURR,[OM/1]OGAH MUNDURR,206,203,-3,24531854,24577454,45600,14720993,14720993,0,526569,526569,0,30001476,30001476,0,1080801,1080801,0,1080801,76634,0
146473478,ᴹᴳHand,ᴹᴳHand,[OM/1]OGAH MUNDURR,[OM/1]OGAH MUNDURR,207,205,-2,24518465,24527265,8800,51684723,51684723,0,1240307,1240307,0,2684418,2684418,0,3758457,3758457,0,3758457,338344,0
153742647,Beast Watcher,Beast Watcher,[1/TE]Twilight~Errant,[1/TE]Twilight~Errant,208,204,-4,24427263,24534579,107316,68409534,68409534,0,721322,721322,0,52000000,52000000,0,-1,5517093,5517094,-1,437296,0
151208703,MCDaredo,MCDaredo,[31Ws]Whisky & Soda,[31Ws]Whisky & Soda,209,206,-3,24378444,24525562,147118,20561359,20568349,6990,428264,428264,0,74672480,74672480,0,1457250,1457949,699,1457250,111281,0
153058186,MACTAViSH,MACTAViSH,[31Ws]Whisky & Soda,[31Ws]Whisky & Soda,210,201,-9,24374802,24594571,219769,5126008,5126008,0,695263,695263,0,0,0,0,264286,264286,0,264286,87012,0
146469847,ᵀᴱL1ght,ᵀᴱL1ght,[1/TE]Twilight~Errant,[1/TE]Twilight~Errant,211,192,-19,25067773,25120949,53176,209014,209014770,208805756,2557638,2557638,0,1007475978,1007475978,0,14458601,14458601,0,14458601,1142351,0
148645696,Cileupeung,Cileupeung,[OM/1]OGAH MUNDURR,[OM/1]OGAH MUNDURR,212,212,0,24263301,24290317,27016,36192153,36192153,0,1399153,1399153,0,150716000,150716000,0,2403796,2403796,0,2403796,361816,0
151151858,ʷˢ NoobMIT,ʷˢ NoobMIT,[31Ws]Whisky & Soda,[31Ws]Whisky & Soda,213,202,-11,24362717,24610465,247748,21904640,21904640,0,701996,701996,0,264980000,264980000,0,1309553,1309553,0,1309553,228833,0
145375164,ᴼᵐTĭểuLa,ᴼᵐTĭểuLa,[OM/1]OGAH MUNDURR,[OM/1]OGAH MUNDURR,214,216,2,24243669,24267869,24200,15906966,15906966,0,1184424,1184424,0,244455640,244455640,0,1184607,1184607,0,1184607,114560,0
147613961,ᴱᴳ Tizzil,ᴱᴳ Tizzil,[31Ws]Whisky & Soda,[31Ws]Whisky & Soda,215,217,2,24205189,24230289,25100,15629103,15629103,0,1481255,1481255,0,35603895,35603895,0,1315954,1315954,0,1315954,29194,0
146708188,Telet Menggila,Telet Menggila,[1/TE]Twilight~Errant,[1/TE]Twilight~Errant,216,208,-8,24368175,24445151,76976,51288048,51297028,8980,1266341,1266341,0,2613104809,2613104809,0,3411972,3412870,898,3411972,335263,0
153384915,Kak Seto,Kak Seto,[JH31]JANDA HUNTER XV,[1/TE]Twilight~Errant,217,211,-6,24195155,24325879,130724,32063011,32063011,0,295642,295642,0,0,0,0,2842238,2842238,0,2842238,140501,0
145925165,ᴼᵐREDveluv,ᴼᵐREDveluv,[OM/1]OGAH MUNDURR,[OM/1]OGAH MUNDURR,218,214,-4,24185676,24390586,204910,45559437,45559437,0,352499,352499,0,139950100,139950100,0,3836136,3836136,0,3836136,198270,0
153782672,The Joker89,The Joker89,[OM/1]OGAH MUNDURR,[OM/1]OGAH MUNDURR,219,213,-6,24242553,24278276,35723,9218624,9218624,0,185869,185869,0,0,0,0,741004,741004,0,741004,86126,0
152989309,Naräka,Naräka,#error#,#error#,220,219,-1,24169330,24169330,0,21311872,21311872,0,117071,117071,0,1,1,0,1766105,1766105,0,1766105,107557,0
153744739,Lady Veeka,Lady Veeka,#error#,#error#,221,220,-1,24138258,24138258,0,3307762,3307762,0,629779,629779,0,40687729,40687729,0,-1,227784,227785,-1,32257,0
153209842,Minahasa001,Minahasa001,#error#,#error#,222,226,4,24029727,24006122,-23605,27356135,27396004,39869,385476,385476,0,31275241,31275241,0,2209378,2209378,0,2209378,72755,0
150867084,ᴳᴾLontrikus,ᴳᴾLontrikus,[31Ws]Whisky & Soda,[31Gp]GOLDEN PHOENIX,223,246,23,24077571,23021883,-1055688,28375137,29479897,1104760,422460,422460,0,222077780,222077780,0,1921986,2025790,103804,1921986,44714,3336
149361157,ᴼᵐZwaxsa,ᴼᵐZwaxsa,[OM/1]OGAH MUNDURR,[OM/1]OGAH MUNDURR,224,209,-15,24175911,24384195,208284,75840481,75840481,0,911858,911858,0,2004887827,2004887827,0,5876459,5876459,0,5876459,571576,0
153690235,ᴼᵐkhoceng,ᴼᵐkhoceng,[OM/1]OGAH MUNDURR,[OM/1]OGAH MUNDURR,225,221,-4,24013561,24122058,108497,91636885,91636885,0,993055,993055,0,389285506,389285506,0,7040332,7040332,0,7040332,499941,0
152565308,ᴼᵐTDD,ᴼᵐTDD,[OM/1]OGAH MUNDURR,[OM/1]OGAH MUNDURR,226,228,2,23889923,23905539,15616,87096530,87096530,0,1287702,1287702,0,795184394,795184394,0,5300024,5300024,0,5300024,300659,0
153844807,Pí cà chu,Pí cà chu,[1/TE]Twilight~Errant,[1/TE]Twilight~Errant,227,199,-28,23690406,24714163,1023757,87307824,88930784,1622960,1010558,1010558,0,297021680,297021680,0,6016613,6121743,105130,6016613,1026555,28583
153148677,ᴼᴹZakuu,ᴼᴹZakuu,[OM/1]OGAH MUNDURR,[OM/1]OGAH MUNDURR,228,218,-10,23799729,24205707,405978,163565,163565719,163402154,855052,855052,0,148693949,148693949,0,12978961,12978961,0,12978961,539512,0
153184719,Nikitaa333,Nikitaa333,#error#,#error#,229,230,1,23779705,23779705,0,1306095,1306095,0,40138,40138,0,4000000,4000000,0,88055,88055,0,88055,13450,0
153791027,TidurSiang,TidurSiang,[1/TE]Twilight~Errant,[1/TE]Twilight~Errant,230,229,-1,23768325,23781525,13200,44610891,44622041,11150,482062,482062,0,275200000,275200000,0,3171068,3172183,1115,3171068,343256,0
151227977,ᴼᵐDFFA彡,ᴼᵐDFFA彡,[OM/1]OGAH MUNDURR,[1/TE]Twilight~Errant,231,197,-34,24231558,24825086,593528,108094,108094684,107986590,2218153,2218153,0,50334678,50334678,0,8538917,8538917,0,8538917,715695,0
153922198,Mighty tempest,Mighty tempest,[1/TE]Twilight~Errant,[1/TE]Twilight~Errant,232,231,-1,23702357,23717594,15237,124176,124176520,124052344,941110,941110,0,723304484,723304484,0,10110400,10110400,0,10110400,840719,0
148420543,ᴼᵐ Sĩlĩw,ᴼᵐ Sĩlĩw,[OM/1]OGAH MUNDURR,[OM/1]OGAH MUNDURR,233,225,-8,23592902,24008722,415820,104882,104882287,104777405,1292523,1292523,0,219797430,219797430,0,8194679,8194679,0,8194679,820483,0
151280863,ᴿᴷMikeツ,ᴿᴷMikeツ,[OM/1]OGAH MUNDURR,[OM/1]OGAH MUNDURR,234,233,-1,23581367,23602451,21084,84988658,84988658,0,1266792,1266792,0,146787101,146787101,0,5799263,5799263,0,5799263,1049990,0
153281508,ᴼᵐ TeAmMoRe,ᴼᵐ TeAmMoRe,[OM/1]OGAH MUNDURR,[OM/1]OGAH MUNDURR,235,234,-1,23588431,23589115,684,72189901,72189901,0,1236784,1236784,0,106101438,151101438,45000000,6020171,6020171,0,6020171,432003,0
153793312,ʷˢVladlen,Your Reaper,[1/TE]Twilight~Errant,[31Ws]Whisky & Soda,236,300,64,23472963,21103936,-2369027,26079183,13331463,-12747720,477206,704717,227511,12000000,21520667,9520667,2167073,717718,-1449355,2167073,253864,78927
153868443,ʳᵘ Bl4ckB1rd,ʳᵘ Bl4ckB1rd,#error#,#error#,237,235,-2,23412299,23412299,0,36228975,36228975,0,656877,656877,0,29876904,29876904,0,3070652,3070652,0,3070652,119813,0
148181060,ᴼᵐE tv,ᴼᵐE tv,[OM/1]OGAH MUNDURR,[OM/1]OGAH MUNDURR,238,236,-2,23383572,23398482,14910,76257588,76257588,0,1174808,1174808,0,296951666,296951666,0,5794875,5794875,0,5794875,838517,0
148598912,AJ DARK SAID 12,AJ DARK SAID 12,[31Ws]Whisky & Soda,[31Ws]Whisky & Soda,239,249,10,23093038,22973314,-119724,74522685,75663225,1140540,1531701,1576796,45095,134916720,134916720,0,5455449,5551241,95792,5455449,681050,9131
149756815,ᴼᴹ King M,ᴼᴹ King M,[31Ws]Whisky & Soda,[31Ws]Whisky & Soda,240,237,-3,23336745,23355445,18700,19204061,19204061,0,443128,443128,0,1309067,1309067,0,1588910,1588910,0,1588910,97417,0
146829777,ɴᴇꜱꜱɪe,ɴᴇꜱꜱɪe,[JH31]JANDA HUNTER XV,[JH31]JANDA HUNTER XV,241,239,-2,23327411,23327411,0,55519424,55519424,0,1512059,1512059,0,3400355249,3400355249,0,3086364,3086364,0,3086364,278839,0
148509955,ᶻᵉMrPlay,ᶻᵉMrPlay,[31Ws]Whisky & Soda,[31Ws]Whisky & Soda,242,242,0,23281046,23262178,-18868,15633009,15639979,6970,215926,215926,0,353259631,353259631,0,1397750,1398447,697,1397750,37933,0
153780223,Thương1994,Thương1994,[1/TE]Twilight~Errant,[1/TE]Twilight~Errant,243,223,-20,23768796,24063889,295093,35899200,35899200,0,665044,665044,0,631748341,631748341,0,2560205,2560205,0,2560205,229326,0
153730748,ᵀᴱHoserem,ᵀᴱHoserem,[1/TE]Twilight~Errant,[1/TE]Twilight~Errant,244,241,-3,23251005,23278213,27208,10131609,10131609,0,194562,194562,0,432469,432469,0,-1,838831,838832,-1,42640,0
145649566,ᴼᴹVoldigoad,ᴼᴹVoldigoad,[1/TE]Twilight~Errant,[1/TE]Twilight~Errant,245,268,23,23237646,22384410,-853236,59579089,61040375,1461286,1577145,1733362,156217,124397646,124397646,0,4332860,4425978,93118,4332860,663746,26487
153841023,anvares3,anvares3,[31Ws]Whisky & Soda,[31Ws]Whisky & Soda,246,238,-8,23203940,23330340,126400,43082031,43082031,0,575894,575894,0,39800841,39800841,0,3308995,3308995,0,3308995,293891,0
151050314,The Dark Lion,The Dark Lion,[31Gp]GOLDEN PHOENIX,[31Gp]GOLDEN PHOENIX,247,240,-7,23142270,23297147,154877,9943838,9944638,800,116109,116109,0,397157630,397157630,0,682216,682296,80,682216,1653,0
150728203,ᴳᵇ   S,ᴳᵇ   S,[31Ws]Whisky & Soda,[31Ws]Whisky & Soda,248,244,-4,23117410,23101432,-15978,96622831,97609851,987020,2439425,2494066,54641,241707215,241707215,0,7515423,7599484,84061,7515423,543642,7259
153192221,ᵀᴱasgasrok,ᵀᴱasgasrok,[31Ws]Whisky & Soda,[31Ws]Whisky & Soda,249,245,-4,23099647,23099647,0,25902876,25902876,0,799359,799359,0,23091078,23091078,0,2244179,2244179,0,2244179,94255,0
151194736,ʷˢAmieツ,ʷˢAmieツ,[31Ws]Whisky & Soda,[31Ws]Whisky & Soda,250,261,11,22571504,22527481,-44023,22863000,23180890,317890,1005351,1005351,0,296487044,296487044,0,1572339,1576598,4259,1572339,194892,13765
153343857,ᴼᵐAska,ᴼᵐAska,[OM/1]OGAH MUNDURR,[OM/1]OGAH MUNDURR,251,232,-19,23085222,23705489,620267,133013,133013770,132880757,1144932,1144932,0,50722959,50722959,0,10209214,10209214,0,10209214,548737,0
150321755,ʷˢB Mirror,ʷˢB Mirror,[31Ws]Whisky & Soda,[31Ws]Whisky & Soda,252,293,41,22994268,21294791,-1699477,16928134,19002774,2074640,438729,938349,499620,0,0,0,1333414,1532318,198904,1333414,24670,4280
147102637,ᵀᴱKAYZER,ᵀᴱKAYZER,#error#,#error#,253,247,-6,22989255,22989255,0,65802248,65802248,0,1195340,1195340,0,40120000,40120000,0,5278586,5278586,0,5278586,275858,0
153447456,ᴼᴹ AmmureTa,ᴼᴹ AmmureTa,[JH31]JANDA HUNTER XV,[JH31]JANDA HUNTER XV,254,248,-6,22975892,22975892,0,58965420,58965420,0,1265992,1265992,0,116169600,116169600,0,4668545,4668545,0,4668545,434901,0
150276906,ᴳᵇTroKsler,ᴳᵇTroKsler,[OM/1]OGAH MUNDURR,[OM/1]OGAH MUNDURR,255,243,-12,22980955,23379289,398334,32683553,32683553,0,1436151,1436151,0,9123012,9123012,0,2688252,2688252,0,2688252,161155,0
153735229,ᴼᵐ Max,ᴼᵐ Max,[OM/1]OGAH MUNDURR,[OM/1]OGAH MUNDURR,256,250,-6,22949865,22966981,17116,24363424,24363424,0,532799,532799,0,0,0,0,1760016,1760016,0,1760016,229134,0
150291292,ᴳᵇ COLBAK,ᴳᵇ COLBAK,[31Ws]Whisky & Soda,[31Ws]Whisky & Soda,257,281,24,22940358,21688114,-1252244,19914583,22549683,2635100,482750,688805,206055,56320100,56320100,0,1123481,1317031,193550,1123481,382207,34980
153840916,ᵀᴱ kiemle,ᵀᴱ kiemle,[1/TE]Twilight~Errant,[1/TE]Twilight~Errant,258,272,14,22778833,22100581,-678252,86971737,87752487,780750,1262101,1262435,334,190397332,190397332,0,6257524,6302301,44777,6257524,587144,16649
155475443,ᵀᴱNickMori,ᵀᴱNickMori,[OM/1]OGAH MUNDURR,[1/TE]Twilight~Errant,259,260,1,22887479,22528498,-358981,76705083,78183237,1478154,581696,687595,105899,404583,404583,0,5936535,6022449,85914,5936535,825495,30944
152966548,ᵀᴱ O҉RCA,ᵀᴱ O҉RCA,[OM/1]OGAH MUNDURR,[OM/1]OGAH MUNDURR,260,253,-7,22708365,22708365,0,63514309,63514309,0,184052,184052,0,37202280,37202280,0,5204851,5204851,0,5204851,88173,0
150997974,ʷˢMech,ʷˢMech,[31Ws]Whisky & Soda,[31Ws]Whisky & Soda,261,254,-7,22681585,22694951,13366,23349173,23349173,0,1240798,1240798,0,19397539,19397539,0,1893676,1893676,0,1893676,159564,0
111817019,ᴼᵐKizaru,ᴼᵐKizaru,[OM/1]OGAH MUNDURR,[OM/1]OGAH MUNDURR,262,255,-7,22630876,22656476,25600,14086075,14086075,0,807371,807371,0,10340763,10340763,0,1038995,1038995,0,1038995,137834,0
150341664,ᴳᵇSatria,ᴳᵇSatria,[31Ws]Whisky & Soda,[31Ws]Whisky & Soda,263,256,-7,22593454,22605450,11996,19485388,19485388,0,513277,513277,0,30011122,30011122,0,1495086,1495086,0,1495086,144143,0
153286958,ᵀᴱCodeZero,ᵀᴱCodeZero,[1/TE]Twilight~Errant,[1/TE]Twilight~Errant,264,251,-13,22576936,22896944,320008,46071950,46105350,33400,1478998,1479133,135,36207353,36207353,0,3491672,3492032,360,3491672,417378,1490
153779604,QuangLuynh,QuangLuynh,[OM/1]OGAH MUNDURR,[1/TE]Twilight~Errant,265,265,0,22560915,22505095,-55820,21497959,21983039,485080,995435,995435,0,0,0,0,1440916,1467790,26874,1440916,151127,10817
153778184,ᵀᴱ Chin Su,ᵀᴱ Chin Su,[1/TE]Twilight~Errant,[1/TE]Twilight~Errant,266,258,-8,22650398,22549225,-101173,109818,112131791,112021973,1185713,1230287,44574,412734552,437734552,25000000,8736608,8841651,105043,8736608,1022308,63125
153109823,ᵀᴱEdominic,ᵀᴱEdominic,#error#,#error#,267,259,-8,22539866,22539866,0,56903923,56903923,0,426207,426207,0,31809959,31809959,0,-1,4534991,4534992,-1,108808,0
150460053,ᴳˢBup,ᴳˢBup,[OM/1]OGAH MUNDURR,[OM/1]OGAH MUNDURR,268,263,-5,22489288,22516764,27476,36724525,36724525,0,438024,438024,0,15447000,15447000,0,2830067,2830067,0,2830067,335711,0
153798799,NTPK,NTPK,[1/TE]Twilight~Errant,[1/TE]Twilight~Errant,269,252,-17,22591220,22903036,311816,89821589,89821589,0,247735,247735,0,27657796,27657796,0,7799132,7799132,0,7799132,431455,0
148380618,ᵀᴱ Drilchik,ᵀᴱ Drilchik,[OM/1]OGAH MUNDURR,[OM/1]OGAH MUNDURR,270,267,-3,22404154,22404154,0,50910544,50910544,0,839542,839542,0,448594803,448594803,0,3480954,3480954,0,3480954,485706,0
148215323,ᴼᵐDANI AJAX,ᴼᵐDANI AJAX,[OM/1]OGAH MUNDURR,[OM/1]OGAH MUNDURR,271,269,-2,22288857,22301007,12150,22720001,22720001,0,611404,611404,0,493917294,493917294,0,1635298,1635298,0,1635298,276033,0
153739962,ANSHAN,ANSHAN,[LP/1]legion of Phoenix,[LP/1]legion of Phoenix,272,266,-6,22225588,22416561,190973,3368388,3368388,0,980234,980234,0,25434959,28044959,2610000,-1,257030,257031,-1,4445,0
145963483,ᴼᴹNceff,ᴼᴹNceff,[OM/1]OGAH MUNDURR,[OM/1]OGAH MUNDURR,273,257,-16,22220392,22576529,356137,14237117,14237117,0,337641,337641,0,55495691,55495691,0,1094779,1094779,0,1094779,149667,0
153853661,LanaMiLuMa,LanaMiLuMa,[OM/1]OGAH MUNDURR,[OM/1]OGAH MUNDURR,274,270,-4,22214044,22341788,127744,15894921,15894921,0,730857,730857,0,7582970,7582970,0,1143618,1143618,0,1143618,84559,0
153385258,ᴼᵐBiuBiu,ᴼᵐBiuBiu,[OM/1]OGAH MUNDURR,#error#,275,262,-13,22499753,22526953,27200,72939826,72939826,0,1242759,1242759,0,161268554,168247787,6979233,5369970,5369970,0,5369970,271117,0
147679510,Betico91,Betico91,#error#,#error#,276,273,-3,22050216,22050216,0,10987538,10987538,0,185667,185667,0,7703821,7703821,0,920260,920260,0,920260,26228,0
153737377,ᵀᴱ Megatron,ᵀᴱ Megatron,[1/TE]Twilight~Errant,[OM/1]OGAH MUNDURR,277,274,-3,21975369,22021457,46088,305716,305716261,305410545,2553022,2553022,0,374289146,374289146,0,12,21544463,21544451,12,1122381,0
153516798,ᴼᵐ OGAH AH,ᴼᵐ OGAH AH,[OM/1]OGAH MUNDURR,[OM/1]OGAH MUNDURR,278,264,-14,21971787,22509484,537697,176398,176398817,176222419,755709,755709,0,358916826,358916826,0,12597519,12597519,0,12597519,302485,0
150297641,۞PRᶦMᵃTᵉ,۞PRᶦMᵃTᵉ,[31Ws]Whisky & Soda,[31Ws]Whisky & Soda,279,271,-8,21962022,22188270,226248,54566905,54566905,0,1197668,1197668,0,5793013,5793013,0,4182671,4182671,0,4182671,383728,0
153175442,NBNCᴼᴹ,NBNCᴼᴹ,[HAFN]Childpredators,[HAFN]Childpredators,280,277,-3,21900312,21900312,0,49994765,49994765,0,1874944,1874944,0,1209490021,1209490021,0,3072000,3072000,0,3072000,223834,0
153046101,ᵀᴱCT乡ROCK,ᵀᴱCT乡ROCK,[G~KL]Knight's Lion Heart,[G~KL]Knight's Lion Heart,281,279,-2,21773297,21773297,0,22575400,22575400,0,160971,160971,0,6395016,6395016,0,1604285,1604285,0,1604285,12370,0
153328597,ᴼᵐTakgentaR,ᴼᵐTakgentaR,[OM/1]OGAH MUNDURR,[OM/1]OGAH MUNDURR,282,278,-4,21863378,21913924,50546,51655933,51655933,0,1545328,1545328,0,123604835,123604835,0,3963678,3963678,0,3963678,283815,0
153770877,InTheNameOf GOD,InTheNameOf GOD,[OM/1]OGAH MUNDURR,[OM/1]OGAH MUNDURR,283,280,-3,21661954,21733097,71143,3592599,3592599,0,212243,212243,0,1235000,2135000,900000,298829,298829,0,298829,11992,0
153744766,VN 1st,VN 1st,[1/TE]Twilight~Errant,[OM/E]familyOM~,284,282,-2,21983309,21664788,-318521,80041382,83054332,3012950,181264,214498,33234,14607953,14607953,0,6448791,6658914,210123,6448791,477441,45586
153338750,ᵀᴱHara 女,ᵀᴱHara 女,[1/TE]Twilight~Errant,[1/TE]Twilight~Errant,285,276,-9,21835047,21943370,108323,131436,133245018,133113582,1687807,1887152,199345,706874621,706874621,0,9558468,9683117,124649,9558468,343072,951
153793259,Dazzac,Dazzac,[JH31]JANDA HUNTER XV,[JH31]JANDA HUNTER XV,286,275,-11,21621640,21965019,343379,5781339,5793559,12220,524290,524290,0,12677205,12677205,0,420735,421957,1222,420735,39071,0
153730937,Reidmar,Reidmar,[LP/1]legion of Phoenix,[LP/1]legion of Phoenix,287,283,-4,21626964,21641692,14728,7935546,7940206,4660,259442,259442,0,170138623,170138623,0,680074,680540,466,680074,15248,0
153262953,ᴼᵐ bocil99,ᴼᵐ bocil99,[OM/1]OGAH MUNDURR,[OM/1]OGAH MUNDURR,288,287,-1,21570421,21643354,72933,103478,103478905,103375427,1273095,1273095,0,16324450,20324450,4000000,8183443,8183443,0,8183443,968509,0
153738509,xvHADD,xvHADD,[OM/1]OGAH MUNDURR,[1/TE]Twilight~Errant,289,284,-5,21610691,21632873,22182,32611756,32611756,0,544550,544550,0,43111239,43111239,0,2577590,2577590,0,2577590,239208,0
153269443,SenseiStorm,SenseiStorm,[OM/1]OGAH MUNDURR,[OM/1]OGAH MUNDURR,290,285,-5,21606162,21606162,0,2315152,2315152,0,111939,111939,0,0,0,0,104106,104106,0,104106,0,0
153672254,ᴼᵐ Rascal,ᴼᵐ Rascal,[OM/1]OGAH MUNDURR,[OM/1]OGAH MUNDURR,291,288,-3,21489679,21530911,41232,45608939,45608939,0,676618,676618,0,51936522,51936522,0,3679029,3679029,0,3679029,153328,0
153574718,ᵛᶰVANTHAIBK,ᵛᶰVANTHAIBK,#error#,[31Ws]Whisky & Soda,292,289,-3,21426980,21469885,42905,6918041,6918041,0,391649,391649,0,0,0,0,474858,474858,0,474858,105657,0
153225883,ᴼᴹHancuK,ᴼᴹHancuK,[G31N]GANENDRA~AMERTA,[G31N]GANENDRA~AMERTA,293,290,-3,21404990,21404990,0,111321,111321722,111210401,1508782,1508782,0,3536363970,3536363970,0,7635372,7635372,0,7635372,333926,0
145860012,ᴼᴹOseng17,ᴼᴹOseng17,[OM/1]OGAH MUNDURR,[OM/1]OGAH MUNDURR,294,291,-3,21363842,21396108,32266,32666525,32666525,0,684933,684933,0,125372465,125372465,0,2338762,2338762,0,2338762,53839,0
90949409,destan80,destan80,[OM/1]OGAH MUNDURR,[OM/1]OGAH MUNDURR,295,294,-1,21227668,21256958,29290,38649118,38649297,179,554880,554880,0,157287827,157287827,0,-1,3205346,3205347,-1,207569,0
150770758,ᴳᵇMiss K,Your Reaper,[31Ws]Whisky & Soda,[31Ws]Whisky & Soda,296,300,4,21219913,21103936,-115977,4394588,13331463,8936875,53581,704717,651136,11687367,21520667,9833300,285279,717718,432439,285279,253864,220679
153734233,ᴼᵐviora,ᴼᵐviora,#error#,#error#,297,295,-2,21216469,21216469,0,2261509,2261509,0,67603,67603,0,29193914,29193914,0,141302,141302,0,141302,26918,0
153065798,XohoX,XohoX,#error#,#error#,298,297,-1,21167557,21167557,0,32657043,32657043,0,930705,930705,0,214560691,214560691,0,2523864,2523864,0,2523864,166097,0
153216883,ᴼᵐAmYouNG,Your Reaper,[JH31]JANDA HUNTER XV,[31Ws]Whisky & Soda,299,300,1,21155073,21103936,-51137,60720989,13331463,-47389526,510425,704717,194292,32600002,21520667,-11079335,5267253,717718,-4549535,5267253,253864,-4302
153071678,republik askar,republik askar,[31Ws]Whisky & Soda,[31Ws]Whisky & Soda,300,296,-4,21154720,21192452,37732,8843484,8878994,35510,155120,155120,0,2200000,2200000,0,-1,598472,598473,-1,56997,0

REPORT NAME,REPORT DATE,PLAYERS,TOP300 TOTAL POWER,TOP300 AVERAGE POWER,TOP300 TOTAL KP,TOP300 AVERAGE KP,TOP300 TOTAL T4KILLS,TOP300 AVERAGE T4KILLS,TOP300 TOTAL T5KILLS,TOP300 AVERAGE T5KILLS
Z1,2023-09-07 15:16:56.207954,300,9628091472,32093638.24,9011225842,30037419.473333333,4047045564,13490151.88,842938789,2809795.9633333334
Z2,2023-09-08 07:54:56.218236,300,9598495969,31994986.563333333,61982806871,206609356.23666668,4138710165,13795700.55,846361800,2821206.0
